============.===============
=..........=...............=
=..........=...............=
=...........*..............=
=....===============.......=
=....=.....................=
=....=.............=.......=
.....===============........
=..................*.......=
=..........................=
=....===============.......=
=....*.............*.......=
=........=====.............=
=..........................=
============.===============